#####################
#x......#...#......x#
#.###.#.#.#.#.#.###.#
#.....#...#...#.....#
#.###.###.#.###.###.#
#.#.......#.......#.#
#.#.### ##### ###.#.#
T.....    R     ....T
#.###.# ## ## #.###.#
#.###.# #BPO# #.###.#
#.....# ##### #.....#
# ###.#       #.### #
#   #.# ##### #.#   #
### #.....#.....# ###
#   #.###.#.###.#   #
# ###.#...@...#.### #
#.....#.#.#.#.#.....#
#.#.###.#.#.#.###.#.#
#.#.....#...#.....#.#
#.#####.#####.#####.#
#x.................x#
#####################
