#######T#######
#B...........O#
#.............#
#.............#
#......@......#
#.............#
#.............#
#.............#
#.............#
#.............#
#R...........P#
#######T#######
